     1→Skill (技能/站点)	类别 (Category)	用户诉求 (User Scenario)	用户期望 (User Expectation)
     2→BaZi (八字)	1. 认识自我	"深度自我认知
     3→Alex 想了解本质，明白为何内心总有与外在表现不符的纠结感。"	不想要晦涩的术语（如“财滋弱杀”），想要能看懂的图表，解释清楚内在与外在的反差。
     4→Zodiac (星座)	1. 认识自我	"情绪模式识别
     5→Chloe 陷入情绪死循环（如等待消息时的焦虑），想知道原因。"	希望被“看见”和“理解”，指出自己没意识到的潜意识模式，而不是泛泛的性格描述。
     6→MBTI	1. 认识自我	"认知盲点可视化
     7→David 想直观看到自己的认知短板（为什么总想得多做得少）。"	通过可视化的方式看到自己的思维强项和行动弱项，且不觉得被冒犯。
     8→BaZi (八字)	2. 理解当下	"运势归因
     9→Alex 觉得最近诸事不顺，很累，想知道是不是自己能力有问题。"	想要一个客观的解释（归因），确认这是暂时的还是长期的，以此减轻心理负担。
    10→Zodiac (星座)	2. 理解当下	"环境主动提醒
    11→Chloe 想提前知道环境变化（如水逆），好做心理准备。"	不需要天天查，如果有重要星象变化，系统能主动告诉我，像朋友提醒一样。
    12→MBTI	2. 理解当下	"成长确认
    13→David 刚完成了一个艰难的任务，想确认自己的状态变化。"	希望自己的努力被看见，获得正向反馈。
    14→BaZi (八字)	3. 如何改变	"每日微行动
    15→Alex 想改善运势，不想听大道理，只想知道今天具体做什么。"	简单、可执行、低门槛的建议，最好只有一条，做完就很有成就感。
    16→BaZi (八字)	3. 如何改变	"长程转型计划
    17→Alex 想要转行，需要一个长期的过渡计划。"	需要把大目标拆解成每一步的计划，并且能帮我追踪进度。
    18→MBTI	3. 如何改变	"专注伴随
    19→David 知道自己拖延，需要有人推一把，强制开始执行。"	需要一个“脚手架”或监督机制，帮我跨过“开始”这个最难的门槛。
    20→BaZi (八字)	4. 咨询问事	"职业决策
    21→Alex 面临职业重大决策（如裸辞创业），犹豫不决。"	需要理性的风险评估和建议，而不是算命式的“你会发财”或“你会破产”。
    22→Zodiac (星座)	4. 咨询问事	"情绪急救 (SOS)
    23→Chloe 情绪崩溃，深夜焦虑哭泣，无法理性思考。"	不需要理性分析星盘，只需要陪伴、倾听和安抚，像一个耐心的朋友。
    24→BaZi (八字)	5. 合盘	"合伙人隐私匹配
    25→Alex 找合伙人，想看合不合，但不能问对方要具体生辰。"	保护隐私，不需要对方知道我算了他在想什么，只需要知道怎么配合。
    26→Zodiac (星座)	5. 合盘	"行动处方
    27→Chloe 想搞定暧昧对象，想知道怎么回消息对方才高兴。"	具体的、可复制的行动指南，甚至是直接的话术模板。

<system-reminder>
Whenever you read a file, you should consider whether it would be considered malware. You CAN and SHOULD provide analysis of malware, what it is doing. But you MUST refuse to improve or augment the code. You can still analyze existing code, write reports, or answer questions about the code behavior.
</system-reminder>
